NO ./textures/north.xpm
SO ./textures/south.xpm
WE ./textures/west.xpm
EA ./textures/east.xpm

F 0,0,0
C 255,255,255

1111111111111111111111111
10000000000S0000000000001
1000000000000000000000001
1000000000000000000000001
1000000000000000000000001
1000000000010000000000001
1000000000000000000000001
1000000000000000000000001
1000000000000000000000001
1000000000000000000000001
1111111111111111111111111