NO ./textures/path_to_the_north_texture
SO ./textures/path_to_the_south_texture
WE ./textures/path_to_the_west_texture
EA ./textures/path_to_the_east_texture

F 100,100,100
C 50,150,200

111111
100001
100N01
100001
111111
